########################
#                      #
#                      #
######                 #
#    #                 #
## ###     ####        #
#          #  #        #
#        ###  #        #
#   @    #             #
#        #    #        #
########################