########################
#                      #
#                 d    #
######                 #
#    #                 #
## ###     ####        #
#          #  #        #
#        ###  #        #
#   @    #             #
#        #    #        #
########################